0 0 0 0 0 0 0 0 0
0 0 0 0 0 0 0 0 0
0 1 1 1 1 1 1 1 0
23 27 27 27 27 27 27 27 24
23 1 1 1 1 1 1 1 1
23 1 1 1 1 1 1 1 1
25 1 1 1 1 1 1 1 1
0 1 1 1 1 1 1 1 0
0 37 37 37 37 37 37 37 0