18 0 18 18 18 18 18 0 18
18 0 8 8 8 8 8 0 18
18 0 1 1 1 1 1 0 18
24 23 23 23 23 1 1 0 18
18 0 1 1 23 1 1 0 18
8 0 1 1 23 1 1 0 8
18 0 1 1 23 1 1 0 18
18 0 1 1 23 1 1 0 18
18 0 1 1 25 1 1 0 18