1 1 1 1 1 1 0 2 2
1 1 1 1 1 1 0 2 2
1 1 1 1 1 1 0 11 11
1 1 1 1 1 1 0 2 2
1 1 1 1 1 1 0 8 8
1 1 1 1 1 1 0 2 2
1 1 1 1 1 1 0 2 2
1 1 1 1 1 1 0 2 2
37 37 37 37 37 37 0 37 37