2 2 2 2 2 2 2 2 0
15 15 15 2 0 8 8 8 0
2 2 15 2 0 1 1 1 1
14 14 15 2 0 1 1 15 15
15 15 15 2 0 1 15 14 14
1 1 1 1 0 1 15 2 2
1 1 1 1 0 1 1 15 15
37 37 37 37 0 1 1 1 1
0 0 0 0 0 1 1 1 1