19 1 1 0 0 0 1 1 19
1 19 1 1 1 1 1 19 1
1 1 19 19 18 19 18 1 1
0 1 19 19 18 18 18 1 0
0 1 18 18 19 18 18 1 0
0 1 19 19 18 19 18 1 0
0 1 19 19 18 1 18 1 1
1 19 1 1 1 1 1 19 1
19 1 1 1 37 1 1 1 19