18 18 18 18 18 18 18 18 18
18 18 18 18 18 18 18 18 18
1 1 0 8 8 8 8 8 8
15 15 0 15 15 15 15 15 15
15 15 0 0 10 1 10 1 10
15 15 15 0 0 1 1 1 1
10 10 10 10 0 1 0 1 1
1 1 1 1 1 0 0 0 1
1 1 1 1 0 0 0 0 37