15 13 13 13 13 13 13 13 15
1 15 19 19 19 19 19 15 1
1 15 15 15 19 15 15 15 1
1 1 1 15 19 15 1 1 1
1 1 1 15 19 15 1 1 1
1 1 1 15 19 15 1 1 1
1 1 1 15 15 15 1 1 1
1 1 1 1 1 1 1 1 1
37 37 37 37 37 37 37 37 37