0 0 1 1 1 1 1 0 0
0 1 1 1 1 1 1 1 0
0 1 1 1 0 1 1 1 0
0 1 1 1 1 1 1 24 0
0 1 27 27 27 27 27 27 0
0 1 27 1 0 1 1 1 0
0 1 25 1 1 1 1 1 0
0 1 1 1 1 1 1 1 0
0 0 1 1 1 1 1 0 0