18 18 18 18 0 13 13 13 13
11 11 11 11 0 1 1 1 1
15 15 15 15 1 1 1 1 1
18 18 18 18 0 1 1 1 1
0 1 1 0 0 0 1 1 0
1 1 1 1 0 1 1 1 1
1 1 1 1 1 1 1 1 1
1 1 1 1 0 1 1 1 1
1 1 1 1 0 1 1 1 1