0 0 1 1 1 1 1 0 0
0 1 1 1 1 1 1 1 0
1 1 1 1 7 1 1 1 1
1 1 1 1 1 1 1 1 1
1 1 7 1 0 1 7 1 1
1 1 1 1 1 1 1 1 1
1 1 1 1 7 1 1 1 1
37 1 1 1 1 1 1 1 37
37 37 1 1 1 1 1 37 0