0 25 0 1 1 1 1 1 1
1 28 0 1 1 1 1 1 1
1 28 0 1 1 1 1 1 1
8 23 0 1 1 1 1 1 1
1 28 0 1 1 1 1 1 1
1 28 0 1 1 1 1 1 1
8 23 23 23 23 1 1 1 1
1 1 1 1 23 1 1 1 1
1 1 1 1 24 1 1 1 1