0 0 0 0 18 0 0 0 0
0 0 0 18 18 18 0 0 0
0 0 18 18 0 18 18 0 0
0 2 2 2 2 2 2 2 0
25 23 31 23 34 23 31 23 24
0 2 2 2 2 2 2 2 0
0 0 18 18 0 18 18 0 0
0 0 0 18 18 18 0 0 0
0 0 0 0 18 0 0 0 0