0 0 0 0 0 0 0 0 0
1 1 23 24 0 23 23 23 23
1 1 23 1 0 23 1 1 23
1 1 23 1 0 23 1 1 23
1 1 23 1 0 23 1 1 23
1 1 23 1 0 23 1 1 23
1 1 23 23 23 23 1 1 23
1 1 1 1 1 1 1 1 23
1 0 1 0 1 0 1 0 25