0 0 0 0 0 0 0 0 0
25 0 0 0 0 0 0 0 24
23 23 0 0 0 0 0 23 23
13 23 23 0 0 0 23 23 13
13 13 32 23 0 23 32 13 13
13 13 13 31 34 31 13 13 13
1 1 1 1 1 1 1 1 1
1 1 1 1 1 1 1 1 1
0 1 1 1 1 1 1 1 0