13 13 13 13 24 13 13 13 13
0 26 1 1 23 1 1 26 0
0 0 1 1 23 1 1 1 0
0 0 0 3 27 3 3 0 0
0 0 0 3 27 3 0 0 0
0 0 1 1 23 1 1 0 0
1 1 1 1 25 1 1 1 1
1 1 1 1 0 1 1 1 1
26 1 1 0 0 0 1 1 26