0 26 1 1 26 1 1 26 0
1 1 1 1 1 1 1 1 1
1 1 24 27 31 27 27 1 1
0 1 1 0 1 0 27 1 0
0 1 27 27 27 27 27 1 0
0 1 27 0 1 0 1 1 0
1 1 25 1 1 1 1 1 26
1 1 1 1 1 1 1 1 26
0 1 1 1 1 1 1 1 0