14 14 14 14 1 1 1 1 0
14 25 23 23 23 23 23 1 0
8 0 8 0 8 0 23 1 0
1 1 1 1 23 31 23 1 0
1 1 1 1 24 0 1 1 1
1 1 1 1 1 0 1 1 1
13 0 1 8 8 0 1 1 1
13 0 0 1 1 1 1 1 1
13 0 0 1 1 1 1 1 1