26 1 35 1 1 26 0 13 1
1 1 1 1 1 0 0 0 1
1 1 1 1 1 0 24 0 1
1 1 1 0 1 0 23 0 1
1 1 25 0 23 23 23 0 1
1 1 23 0 23 0 0 0 1
1 0 23 23 23 0 0 0 1
1 0 0 1 0 0 0 0 1
26 1 1 1 1 35 1 1 1