0 0 19 0 19 0 19 0 0
0 0 11 2 11 2 11 0 0
0 0 19 19 10 19 19 0 0
0 2 19 19 19 19 19 2 0
2 2 2 2 2 2 2 2 2
8 2 2 2 2 2 2 2 8
0 8 2 2 2 2 2 8 0
0 0 8 2 2 2 8 0 0
0 0 0 8 2 8 0 0 0