0 2 0 2 0 2 2 2 2
0 2 0 2 0 2 2 2 2
0 8 0 8 0 1 1 1 1
1 1 1 1 1 1 1 1 1
1 1 1 1 1 37 8 8 8
1 1 1 1 1 0 2 0 2
1 1 1 1 1 0 8 8 8
1 1 1 1 1 0 2 2 2
1 1 1 1 1 0 37 37 37