0 0 0 1 1 1 0 0 0
0 0 1 1 1 1 1 0 0
0 0 1 11 11 11 1 0 0
0 7 7 11 1 11 7 7 0
0 1 1 1 1 1 1 1 0
1 1 1 1 1 1 1 1 1
1 1 1 1 1 1 1 1 1
1 1 1 1 1 1 1 1 1
1 1 1 1 1 1 1 1 1