1 1 1 1 0 1 1 1 1
2 2 2 2 0 2 2 2 2
0 2 2 2 0 2 2 2 0
0 0 2 2 0 2 2 0 0
2 0 8 2 0 2 8 0 2
2 2 8 8 3 8 8 2 2
2 2 2 15 15 15 2 2 2
1 1 0 15 15 15 0 1 1
0 1 1 1 1 1 1 1 0