0 1 1 1 1 1 1 1 0
0 1 1 1 1 1 1 1 0
1 1 5 11 5 11 5 1 1
1 1 11 14 11 14 11 1 1
1 1 5 11 11 11 5 1 1
1 1 11 14 11 14 11 1 1
1 1 5 11 5 11 5 1 1
1 1 1 1 1 1 1 1 1
0 1 1 1 1 1 1 1 0