0 13 0 13 0 13 0 13 0
11 5 11 5 11 5 11 5 11
1 11 1 11 1 11 1 11 1
1 1 1 1 1 1 1 1 1
1 1 1 1 1 1 1 1 1
11 5 11 5 11 5 11 5 11
1 1 1 1 1 1 1 1 1
1 1 1 1 1 1 1 1 1
0 1 1 1 1 1 1 1 0