13 0 13 13 0 13 13 0 13
15 15 19 19 15 19 19 15 15
15 19 1 1 1 1 1 19 15
19 1 1 1 1 1 1 1 19
15 1 1 0 1 0 1 1 15
0 15 1 1 1 1 1 15 0
0 15 1 1 1 1 1 15 0
0 0 15 1 1 1 15 0 0
0 0 0 15 2 15 0 0 0