1 1 1 1 0 0 0 0 0
1 1 1 1 0 0 0 0 0
1 1 1 1 1 0 0 0 0
1 1 1 1 1 1 1 1 1
1 1 1 1 1 1 1 1 1
1 1 1 1 1 1 1 1 1
1 1 1 1 0 1 1 1 1
1 1 1 1 0 1 1 1 1
37 37 37 37 0 1 1 1 1