1 1 1 1 0 0 0 0 0
1 1 1 1 0 13 13 13 13
1 1 1 1 0 13 13 13 13
2 2 2 2 2 19 19 19 19
17 17 17 17 0 2 2 2 2
1 1 1 1 0 2 2 2 2
1 1 1 1 0 2 2 2 2
1 1 1 1 0 2 2 2 2
1 1 1 1 0 37 37 37 37