0 15 18 18 18 18 18 18 0
0 13 15 18 18 18 18 18 0
0 13 15 15 15 15 15 15 0
0 2 8 8 8 8 8 8 0
2 2 2 2 2 2 2 2 2
1 1 1 1 1 1 1 1 1
1 1 1 1 1 1 1 1 1
1 1 1 1 1 1 1 1 1
1 1 1 1 1 1 1 1 1