1 1 1 1 1 1 1 1 1
1 1 1 1 1 1 1 1 1
8 0 1 1 1 1 1 0 8
24 31 28 33 28 33 28 0 37
8 0 1 1 1 1 28 0 8
37 0 1 1 1 1 28 31 25
8 0 1 1 1 1 1 0 8
1 1 1 1 1 1 1 1 1
1 1 1 1 1 1 1 1 1