1 1 1 1 1 35 1 35 35
1 1 1 1 1 1 1 26 1
1 1 1 1 1 1 1 26 1
1 25 23 23 23 1 1 1 1
8 8 13 13 31 13 13 8 8
8 8 13 13 23 13 13 8 8
1 1 1 35 23 35 1 1 1
1 1 1 1 24 1 1 1 1
0 1 1 1 1 1 1 1 0