0 1 1 1 1 1 1 1 0
0 1 1 1 23 24 1 1 0
0 0 0 0 27 0 0 0 0
0 0 1 1 23 1 1 0 0
13 0 0 1 23 1 0 0 13
3 1 0 11 31 11 0 1 3
1 1 1 1 23 1 1 1 1
1 1 16 1 25 1 16 1 1
0 1 1 1 1 1 1 1 0