0 1 1 1 1 1 1 1 18
0 1 1 23 23 34 23 24 18
0 1 1 23 1 1 1 1 18
1 1 1 25 1 1 1 1 18
8 8 8 8 8 8 8 0 8
1 1 1 1 1 1 1 0 18
1 1 1 1 1 1 1 0 18
8 8 8 8 8 8 8 0 18
18 18 18 18 18 18 18 0 18