0 1 1 1 1 1 1 1 0
0 1 26 1 1 23 23 25 0
0 1 1 1 1 23 1 1 0
0 1 26 1 1 23 1 1 0
0 13 13 1 1 23 1 1 0
0 24 23 23 23 23 1 1 0
0 1 1 1 26 1 26 1 0
0 26 1 1 1 1 1 1 0
0 1 26 1 1 1 1 26 0