1 1 1 1 11 1 1 1 1
1 1 1 11 10 11 1 1 1
1 1 11 10 9 10 11 1 1
1 11 10 9 9 9 10 11 1
11 10 9 9 9 9 9 10 11
1 11 10 9 9 9 10 11 1
1 1 11 10 9 10 11 1 1
1 1 1 11 10 11 1 1 1
1 1 1 1 11 1 1 1 1