1 1 23 23 24 1 1 1 1
1 1 31 1 0 1 0 1 1
1 0 23 23 23 23 1 1 1
1 1 7 0 11 31 1 1 1
1 1 1 1 23 23 1 1 1
1 0 1 1 23 0 1 1 1
1 1 1 0 25 1 1 1 1
1 1 1 1 1 1 1 1 1
1 1 1 1 1 1 1 1 1