0 13 13 13 0 1 26 1 0
13 13 13 13 0 24 1 1 1
13 13 13 13 0 23 1 26 1
1 1 1 7 0 23 1 1 1
1 1 1 23 23 23 26 1 26
1 1 1 23 0 7 1 1 1
1 1 1 23 0 1 26 1 26
1 1 1 25 0 26 1 1 1
0 1 1 1 0 1 1 1 0