1 0 1 1 1 1 1 1 1
9 9 9 9 0 10 10 10 10
1 1 1 1 0 1 1 1 1
1 1 1 1 0 0 1 1 0
1 1 1 1 0 1 1 1 1
1 1 1 1 0 1 1 1 1
1 1 1 1 1 1 1 1 1
0 1 1 1 0 1 1 1 1
0 1 1 1 0 1 1 1 1