2 2 2 2 2 2 2 2 2
8 8 8 8 8 8 8 8 8
2 1 1 1 1 1 1 1 2
2 2 2 2 2 2 2 2 2
2 1 2 1 2 1 2 1 2
2 2 1 2 1 2 1 2 2
2 1 2 1 2 1 2 1 2
2 2 2 2 2 2 2 2 2
2 0 37 37 37 37 37 0 2