13 13 13 13 3 13 13 13 13
3 3 3 3 3 3 3 3 3
3 3 3 13 13 13 3 3 3
3 13 3 1 1 1 3 13 3
3 13 3 1 1 1 3 13 3
3 13 3 1 1 1 3 13 3
3 3 3 1 1 1 3 3 3
3 3 1 1 1 1 1 3 3
3 1 1 1 1 1 1 1 3