0 0 0 0 0 0 0 0 0
13 13 13 13 13 13 13 13 13
11 11 11 11 11 11 11 11 11
7 7 7 7 7 7 7 7 7
1 1 1 1 1 1 1 1 1
1 1 1 1 1 1 1 1 1
1 1 1 1 1 1 1 1 1
1 1 1 1 1 1 1 1 1
37 37 37 37 37 37 37 37 37