0 0 0 0 24 0 0 0 0
0 0 0 0 23 0 0 0 0
0 1 26 13 23 13 1 26 0
1 1 1 0 23 0 1 1 1
1 1 1 13 34 13 1 26 1
1 1 1 0 23 0 1 1 1
0 1 25 23 23 1 26 1 0
0 1 1 1 1 1 1 1 0
0 1 1 26 1 26 1 1 0