1 1 1 1 1 1 1 1 14
1 1 1 1 1 1 1 1 14
1 1 1 0 0 23 28 23 14
1 1 0 23 28 28 0 23 14
1 1 0 28 0 1 0 23 14
1 1 1 23 1 24 23 23 14
1 1 0 25 0 1 0 1 14
1 1 1 1 1 1 1 1 14
1 1 1 1 1 1 1 1 14