1 1 1 1 1 1 1 1 1
1 1 1 1 1 1 1 1 1
1 23 23 23 31 23 23 23 1
1 23 18 18 18 18 18 23 1
1 25 18 18 0 18 18 23 1
1 1 18 0 0 0 18 24 1
1 11 18 18 0 18 18 11 1
1 1 18 18 18 18 18 1 1
1 1 1 1 11 1 1 1 1