13 13 14 14 14 14 14 13 13
2 0 8 0 13 8 8 0 2
2 0 2 0 15 37 2 2 2
2 2 2 0 15 37 2 2 2
8 8 8 0 15 8 8 8 8
1 1 1 1 1 1 1 1 1
1 1 1 1 1 1 1 1 1
1 1 1 1 1 1 1 1 1
1 1 1 1 1 1 1 1 1