0 1 1 1 1 1 1 1 0
1 1 1 1 1 1 1 1 1
1 1 1 1 23 23 24 1 1
1 1 18 18 23 18 18 1 1
1 1 18 0 23 0 18 1 1
1 1 18 0 23 0 18 1 1
1 1 18 18 23 18 18 1 1
1 1 1 1 25 1 1 1 1
0 1 1 1 1 1 1 1 0