0 0 0 0 0 0 0 0 0
0 0 1 1 1 1 1 0 0
0 1 1 1 1 1 1 1 1
1 18 18 18 18 18 1 1 1
24 23 23 23 23 18 18 18 1
1 18 0 0 23 0 0 18 1
1 18 18 18 23 18 18 18 1
0 1 1 1 23 1 1 1 0
0 0 1 1 25 1 1 0 0