1 1 1 1 1 1 1 1 1
15 15 15 15 15 15 15 15 15
15 15 15 15 15 15 15 15 15
1 1 1 1 1 1 1 1 1
0 1 1 1 1 1 1 1 0
0 1 1 1 1 1 1 1 0
0 37 1 1 1 1 1 37 0
0 37 1 1 1 1 1 37 0
0 0 37 1 1 1 37 0 0