0 1 1 1 26 1 1 1 0
1 2 18 18 23 23 23 24 1
1 2 18 0 23 0 18 2 1
26 2 18 0 23 0 18 2 1
1 2 18 0 23 0 18 2 26
1 2 18 18 23 18 18 2 1
1 1 1 1 23 1 1 1 1
1 1 1 1 23 1 1 1 1
0 26 1 1 25 1 1 1 0