35 1 1 26 1 1 24 1 35
1 1 26 1 1 1 23 1 1
1 1 1 1 1 1 23 1 35
36 36 3 27 27 27 27 36 36
36 36 3 27 3 3 3 36 36
1 1 1 23 1 1 1 1 1
1 1 1 25 1 1 1 1 1
1 1 1 1 1 1 1 1 1
1 1 1 1 1 1 1 1 1