0 0 1 1 23 23 24 1 1
0 1 1 1 23 1 1 1 1
0 1 1 1 23 1 1 1 1
0 1 1 1 23 1 1 1 1
1 1 1 1 23 1 1 1 37
1 1 1 1 23 1 1 1 0
1 25 23 23 23 1 1 1 0
1 1 1 1 1 1 1 37 0
1 1 1 1 37 37 37 0 0