0 0 0 0 0 0 0 0 0
0 0 1 1 1 1 1 0 0
0 1 1 1 1 1 1 1 0
0 1 1 1 1 1 1 1 0
0 1 1 1 23 23 23 24 0
0 1 1 1 23 1 1 1 0
0 1 1 1 23 1 1 1 0
0 37 1 1 25 1 1 37 0
0 0 37 37 37 37 37 0 0