2 2 2 2 2 2 2 1 1
8 8 8 8 8 8 8 0 1
1 1 1 1 1 1 1 0 2
1 1 1 1 1 1 1 0 2
1 1 1 1 1 1 1 0 2
1 1 1 1 1 1 1 0 2
1 1 1 1 1 1 1 0 2
1 1 1 1 1 1 1 0 2
1 1 1 1 1 1 1 0 1