0 0 0 0 0 0 0 0 0
0 1 1 1 1 1 1 1 0
0 24 23 23 27 27 1 1 0
0 1 1 1 1 27 1 1 0
0 1 1 1 1 27 1 1 0
0 1 1 1 1 27 1 1 0
0 1 25 23 27 27 1 1 0
0 1 1 1 1 1 1 1 0
0 1 1 1 1 1 1 1 0