0 1 1 1 1 1 1 0 0
0 1 1 1 1 1 1 0 0
0 1 24 23 23 23 1 0 0
0 1 1 1 1 23 1 0 0
0 1 1 1 1 23 1 0 0
0 1 23 23 23 23 1 0 0
0 1 23 1 1 1 1 0 0
0 1 23 1 1 1 1 0 0
0 1 25 1 1 1 1 0 0