0 0 0 0 0 0 0 0 0
0 1 1 1 1 1 1 0 0
1 1 1 1 1 1 1 1 0
1 1 3 27 27 24 1 1 0
1 1 27 27 3 1 1 1 0
1 1 27 3 3 1 1 1 0
1 1 23 23 23 25 1 1 0
1 1 1 1 1 1 1 1 0
0 1 1 1 1 1 1 0 0