0 1 1 1 1 1 1 1 0
1 1 1 1 1 1 1 1 1
1 1 1 1 1 1 1 1 1
15 1 15 1 15 1 15 1 15
1 15 1 15 1 15 1 15 1
15 1 15 1 15 1 15 1 15
1 15 1 15 1 15 1 15 1
3 1 3 1 3 1 3 1 3
0 1 3 1 3 1 3 1 0