0 1 1 1 1 1 1 0 0
1 1 32 23 23 23 1 1 0
1 1 27 1 1 24 1 1 0
1 1 27 1 1 1 1 1 0
1 1 27 27 27 1 1 1 0
1 1 1 1 27 1 1 1 0
1 1 23 23 32 1 1 1 0
1 1 25 1 1 1 1 1 0
0 1 1 1 1 1 1 0 0