0 1 1 1 1 1 1 0 0
0 1 1 1 24 1 1 0 0
0 1 1 1 23 1 1 0 0
0 1 1 1 34 1 1 0 0
0 1 23 23 23 1 1 0 0
0 1 33 1 1 1 1 0 0
0 1 23 1 1 1 1 0 0
0 1 32 23 25 1 1 0 0
0 1 1 1 1 1 1 0 0