1 1 1 1 1 1 1 1 1
1 3 3 3 3 3 3 3 1
1 3 27 27 27 27 27 3 1
1 3 27 3 3 3 27 3 1
1 1 23 1 1 1 23 1 1
1 1 23 1 1 1 25 1 1
1 1 23 23 23 24 1 1 1
1 1 1 1 1 1 1 1 1
1 1 1 1 1 1 1 1 1