0 1 1 1 1 1 1 0 0
0 1 1 1 1 1 1 0 0
0 24 28 28 28 1 1 0 0
0 1 1 1 28 1 1 0 0
0 1 28 28 28 1 1 0 0
0 1 28 1 1 1 1 0 0
0 1 25 1 1 1 1 0 0
0 1 1 1 1 1 1 0 0
0 37 37 37 37 37 37 0 0