0 1 1 1 1 1 1 1 1
1 1 1 6 6 6 6 1 1
1 1 1 6 2 2 6 1 1
1 1 1 6 2 2 6 1 1
1 1 1 6 6 6 6 1 1
37 1 1 1 1 1 1 1 1
0 37 1 1 1 1 1 1 1
0 37 37 1 1 1 1 1 1
0 37 37 37 1 1 1 1 1