0 0 0 0 0 0 0 0 0
0 0 0 0 0 0 0 0 0
0 1 1 1 1 1 1 1 0
0 0 1 2 6 2 1 0 0
0 1 1 6 6 6 1 1 0
0 0 1 2 6 2 1 0 0
0 1 1 1 1 1 1 1 0
0 1 1 0 1 1 0 1 0
0 37 37 0 37 37 0 37 0