1 1 5 5 5 5 5 1 1
1 1 5 2 5 2 5 1 1
1 1 5 5 5 5 5 1 1
1 1 5 2 5 2 5 1 1
1 1 5 5 5 5 5 1 1
1 1 1 1 1 1 1 1 1
0 1 1 1 1 1 1 1 0
0 1 1 1 1 1 1 1 0
0 0 1 1 1 1 1 0 0