0 1 1 0 0 0 1 1 0
1 1 1 1 3 3 3 1 1
1 1 1 1 3 3 3 1 1
1 1 28 28 28 28 28 24 1
1 1 28 1 0 0 1 1 1
1 1 28 1 0 0 1 1 1
1 1 28 1 1 1 1 1 1
1 1 25 1 1 1 1 1 1
0 1 1 0 0 0 1 1 0