0 0 0 0 0 0 0 0 0
0 3 23 23 23 27 24 26 0
0 3 27 3 3 3 26 26 0
0 3 27 3 3 3 3 3 0
0 1 23 1 1 1 1 1 0
0 1 25 1 1 1 1 26 0
0 1 1 1 1 1 1 1 0
0 1 1 1 1 1 1 26 0
0 37 37 37 37 37 37 37 0