26 1 26 1 26 1 24 26 26
1 1 1 1 1 1 28 1 1
1 1 1 1 1 0 28 0 1
0 1 1 1 1 1 28 1 0
0 1 26 1 1 1 28 1 0
0 1 1 23 28 28 28 1 0
0 1 1 23 1 1 1 1 0
0 1 1 25 1 1 1 1 0
0 0 1 1 1 1 1 0 0