0 0 0 1 1 1 1 0 0
0 1 1 1 1 1 1 1 0
1 1 1 1 1 1 1 1 1
1 1 1 32 23 23 23 24 1
1 1 5 32 5 1 1 1 1
1 1 1 32 1 1 1 1 1
1 23 23 23 1 1 1 1 37
37 25 1 1 1 1 1 37 0
0 37 1 1 1 1 37 0 0