0 1 1 1 0 1 1 1 0
1 1 1 1 0 1 1 1 1
1 1 1 1 0 26 1 26 1
1 1 1 1 0 1 1 1 1
1 23 28 28 27 23 23 24 1
1 23 1 1 0 26 26 1 1
1 23 1 1 0 1 1 1 1
1 25 1 1 0 1 1 1 1
0 1 1 1 0 1 1 1 0