0 0 0 0 0 0 0 0 0
1 1 1 1 1 1 1 1 1
1 3 3 3 3 3 3 3 3
1 3 28 28 28 28 28 24 3
1 3 28 3 3 3 3 3 3
1 3 28 3 1 1 1 1 1
1 3 25 3 1 1 1 1 37
1 3 3 3 1 1 1 37 37
1 1 1 1 1 1 37 37 37