1 1 1 1 1 1 1 1 1
1 1 1 1 1 1 1 1 1
1 1 1 1 24 23 23 1 1
1 1 1 1 1 5 32 5 1
1 1 1 1 1 4 28 1 1
1 23 23 32 23 28 28 1 1
1 23 1 5 1 5 5 1 1
1 25 1 1 1 1 1 1 1
1 1 1 1 1 1 1 1 1