0 0 25 23 32 27 27 26 26
0 0 1 1 1 3 27 26 26
0 0 1 1 1 3 27 26 26
0 0 1 1 1 3 27 3 3
0 0 1 1 1 1 32 1 1
0 1 1 1 1 1 23 1 1
1 1 24 23 23 23 23 1 1
1 1 1 1 1 1 1 1 1
0 1 1 1 1 1 1 1 0