1 1 0 0 0 0 0 1 1
1 1 1 0 0 0 1 1 26
1 1 1 3 0 3 1 24 1
1 1 1 3 3 3 1 23 26
1 23 23 28 32 28 23 23 1
1 23 1 3 3 3 1 1 1
1 25 1 3 0 3 1 1 26
1 1 1 37 0 37 1 1 1
1 1 37 37 0 37 37 1 1