0 0 0 0 2 0 0 0 0
0 0 0 2 2 2 0 0 0
0 0 2 2 2 2 2 0 0
0 2 2 2 6 2 2 2 0
2 2 2 6 2 6 2 2 2
0 2 2 2 6 2 2 2 0
0 0 2 2 2 2 2 0 0
0 0 0 2 2 2 0 0 0
0 0 0 37 2 37 0 0 0