0 0 2 2 2 2 2 0 0
0 2 18 18 18 18 18 2 0
2 2 1 24 23 23 23 23 2
0 2 1 1 1 1 1 23 0
0 2 1 23 23 23 23 23 0
0 2 1 23 1 1 1 2 0
2 2 1 25 1 1 1 2 2
0 2 18 18 18 18 18 2 0
0 37 18 0 18 0 18 37 0