0 1 1 11 11 11 1 1 0
0 1 1 1 1 1 1 1 0
0 0 11 1 1 1 11 0 0
0 0 11 1 1 1 11 0 0
0 1 1 1 1 1 1 1 0
0 1 1 8 8 1 1 1 0
0 1 1 11 11 1 1 1 0
0 1 1 1 1 1 1 1 0
0 1 1 1 1 1 1 1 0