0 0 1 1 1 1 1 0 0
0 1 1 1 1 1 1 1 0
3 3 3 3 3 3 3 3 3
3 3 3 3 3 3 3 3 3
25 28 28 28 34 28 28 28 24
3 3 3 3 3 3 3 3 3
3 3 3 3 3 3 3 3 3
37 1 1 1 1 1 1 1 37
37 37 1 1 1 1 1 37 37