0 1 1 1 1 1 1 1 0
0 1 1 1 23 25 1 1 0
0 1 1 1 32 1 1 1 0
0 1 1 1 23 1 1 1 0
0 1 1 1 34 1 1 1 0
0 1 1 1 23 1 1 1 0
0 1 1 1 34 1 1 1 0
0 1 24 23 23 1 1 1 0
0 1 1 1 1 1 1 1 0