1 1 1 1 1 1 1 1 1
1 1 1 2 2 2 2 2 1
1 1 1 2 2 24 15 2 1
2 2 2 2 2 27 15 2 1
15 15 15 15 15 27 15 2 1
15 25 27 27 27 27 15 2 1
15 15 15 15 15 15 15 2 1
1 1 1 1 1 1 1 1 1
1 1 1 1 1 1 1 1 1