0 1 3 1 26 1 26 26 0
1 1 3 1 1 1 26 1 1
1 1 27 27 31 27 27 3 3
1 1 24 0 8 0 27 26 1
1 1 1 0 8 0 27 1 26
1 1 25 0 8 0 27 26 1
1 1 23 23 23 23 27 3 3
1 1 1 1 1 1 1 1 1
37 1 1 1 1 1 1 1 37