0 0 0 1 25 1 0 0 0
0 0 1 1 23 1 1 0 0
0 1 1 1 23 1 1 1 0
1 1 1 11 31 11 1 1 1
1 1 11 11 31 11 11 1 1
1 1 1 11 31 11 1 1 1
37 1 1 1 23 1 1 1 37
37 37 1 1 23 1 1 37 37
37 37 37 1 24 1 37 37 37