0 0 1 1 1 1 1 1 0
0 1 1 1 1 1 1 1 1
0 1 1 28 31 28 24 1 1
0 1 1 28 4 4 4 1 1
0 1 1 28 4 4 4 1 1
0 1 1 28 4 4 4 1 1
0 1 1 28 31 28 25 1 1
0 1 1 1 1 1 1 1 1
0 0 1 1 1 1 1 1 0