0 0 0 0 0 0 0 0 0
1 1 1 1 1 1 1 1 1
1 1 1 1 1 1 1 1 1
1 1 1 1 1 1 1 1 1
1 1 1 34 23 34 23 34 24
1 1 1 23 1 1 1 1 1
1 1 1 34 1 1 1 1 1
1 25 23 23 1 1 1 1 1
37 37 37 37 37 37 37 37 37