0 0 0 0 0 26 26 26 26
0 0 0 0 0 26 26 26 0
0 0 0 0 0 1 26 26 0
0 0 0 0 0 1 1 1 0
1 1 1 31 34 27 27 24 0
1 1 1 34 1 1 1 1 0
1 1 1 23 1 1 1 1 0
1 1 1 23 1 1 1 1 0
1 1 1 25 1 1 1 1 1