0 0 0 0 0 0 0 0 0
1 1 1 2 1 1 1 2 2
1 1 2 2 2 1 1 2 2
1 1 1 2 1 1 1 1 1
2 1 1 1 1 24 1 1 2
2 1 2 1 1 23 1 1 1
1 1 1 1 1 23 1 1 2
1 25 23 23 23 23 1 1 1
1 1 1 2 2 2 2 1 1