26 1 26 1 1 1 26 1 1
1 1 1 1 1 1 1 1 1
1 1 24 23 34 1 1 1 1
1 1 1 1 23 1 1 1 1
8 8 8 8 31 1 8 8 8
1 1 1 1 31 1 1 1 1
37 1 1 1 23 1 1 1 37
0 37 1 1 25 1 1 37 0
0 0 37 1 1 1 37 0 0