2 2 2 0 2 2 2 2 2
2 2 2 0 2 2 2 2 2
2 2 2 11 2 2 2 2 2
1 1 1 11 11 1 1 1 1
1 1 1 11 11 11 1 1 1
1 1 1 1 11 11 1 1 1
1 1 1 1 1 11 1 1 1
1 1 1 1 1 0 1 1 1
1 1 1 1 1 0 1 1 1