0 0 0 0 0 0 1 1 1
0 0 0 0 0 1 1 1 1
0 0 0 0 1 2 2 2 2
0 0 0 1 1 2 1 1 1
0 0 11 11 11 2 11 11 11
0 1 11 2 11 2 11 2 11
1 1 11 11 11 2 11 11 11
1 1 1 1 1 2 1 1 1
1 1 2 2 2 2 1 1 1