1 1 1 1 1 1 1 1 1
1 0 8 0 1 1 11 11 1
1 0 11 1 1 1 0 0 1
1 1 1 1 1 1 1 1 1
1 1 1 1 0 1 1 1 1
1 1 1 1 1 1 1 1 1
1 0 0 1 1 1 11 0 1
1 11 11 1 1 1 0 0 1
1 1 1 1 1 1 1 1 1