2 2 2 6 2 6 2 2 2
0 1 2 2 6 2 2 1 0
0 0 1 2 2 2 1 0 0
0 0 0 1 11 1 0 0 0
0 0 0 0 11 0 0 0 0
0 0 0 1 1 1 0 0 0
0 0 1 1 1 1 1 0 0
0 1 2 2 6 2 2 1 0
1 1 2 6 2 6 2 1 1