15 15 15 15 11 15 15 15 15
15 2 2 2 11 2 2 2 15
15 2 2 2 11 2 2 2 15
15 2 2 2 11 2 2 2 15
11 11 11 11 11 11 11 11 11
15 2 2 2 9 2 2 2 15
15 2 2 2 2 2 2 2 15
15 2 2 2 2 2 2 2 15
2 37 37 37 37 37 37 37 2