0 1 1 1 1 1 1 1 2
2 1 1 1 1 1 1 1 0
0 1 1 11 11 11 1 1 2
2 1 11 14 14 14 11 1 0
0 1 11 14 14 14 11 1 2
2 1 11 14 14 14 11 1 0
0 1 1 11 11 11 1 1 2
2 1 1 1 1 1 1 1 0
0 1 1 1 1 1 1 1 2