0 0 0 0 0 0 0 0 0
0 1 1 24 1 1 0 0 0
0 1 1 23 1 1 1 0 0
0 1 1 23 1 1 1 1 0
0 1 1 23 23 23 23 23 0
0 1 1 1 1 1 1 23 0
0 37 1 1 1 1 1 23 0
0 0 37 1 1 1 1 25 0
0 0 0 37 37 37 37 37 0