0 2 2 15 15 15 15 15 1
1 2 2 15 24 15 15 15 1
1 2 2 15 28 15 15 15 1
1 2 2 15 28 15 15 15 0
1 2 2 2 34 2 2 2 0
1 2 2 2 28 23 23 25 0
1 1 1 1 1 1 1 1 0
1 1 1 1 1 1 1 1 1
0 1 1 1 1 1 1 1 1