35 35 35 24 23 23 23 23 23
18 18 18 18 18 18 18 18 23
15 15 15 15 15 15 15 18 23
15 26 15 26 15 26 15 18 23
15 15 15 15 15 15 15 18 23
1 1 1 1 1 1 1 1 25
1 1 1 1 1 1 1 1 1
1 1 26 1 1 1 1 1 1
0 1 1 1 1 1 26 1 0