0 1 1 1 1 1 1 0 0
0 1 1 1 1 1 1 0 0
0 1 1 1 1 1 1 0 0
24 4 34 23 31 31 1 0 0
0 0 1 1 1 28 1 0 0
0 0 1 0 0 25 1 0 0
0 0 1 0 0 1 1 0 0
0 0 1 1 1 1 1 0 0
0 0 1 1 1 1 1 0 0