0 0 1 1 1 1 26 0 0
0 1 1 1 1 1 1 1 0
0 1 31 23 23 23 23 24 0
0 1 23 1 8 1 1 26 0
0 1 23 1 14 14 14 1 0
0 1 23 1 14 8 14 1 0
0 1 25 1 14 14 14 1 0
0 1 1 1 1 1 1 1 0
0 0 26 1 1 1 26 0 0