0 0 0 0 0 0 0 0 0
0 1 23 23 27 23 23 27 24
0 8 23 37 8 8 8 8 8
0 1 27 0 1 1 1 1 1
0 8 23 0 1 1 1 1 1
0 1 23 0 1 1 1 1 1
0 8 23 0 1 1 1 1 1
0 1 27 0 1 1 1 1 1
0 37 25 0 1 1 1 1 1