1 1 1 1 1 1 1 1 1
1 1 1 1 1 1 1 1 1
1 1 1 1 1 1 1 1 1
1 1 23 31 25 1 1 1 1
1 1 23 1 1 1 1 1 1
0 1 30 1 1 1 1 1 1
0 1 30 1 0 1 0 1 0
0 8 31 1 0 37 0 37 0
0 1 24 37 0 0 0 0 0