0 14 14 0 14 14 0 14 0
1 1 1 1 1 1 1 1 1
3 3 0 3 1 3 0 1 3
1 1 1 1 34 23 3 24 1
1 0 1 0 23 0 0 1 1
1 1 1 1 33 1 3 1 1
1 1 1 0 23 1 1 1 1
1 1 1 1 25 1 1 1 1
0 1 1 1 1 1 1 1 0