-1 -1 3 0 9 0 1 -1 -1
-1 -1 0 2 4 2 0 -1 -1
-1 -1 4 3 1 3 4 -1 -1
-1 -1 2 0 2 0 1 -1 -1
-1 -1 0 2 4 1 4 -1 -1
-1 -1 -1 -1 -1 -1 -1 -1 -1
-1 -1 2 0 3 4 1 -1 -1
-1 -1 1 2 4 2 4 -1 -1
-1 -1 2 0 1 4 1 -1 -1