-1 -1 15 2 -1 2 0 -1 -1
-1 -1 -1 -1 -1 -1 -1 -1 -1
4 -1 3 0 3 2 0 -1 -1
1 -1 4 2 1 4 2 -1 1
-1 -1 15 3 0 3 4 -1 3
1 -1 2 0 3 1 3 -1 -1
-1 -1 3 4 15 2 15 -1 3
-1 -1 -1 -1 -1 -1 -1 -1 1
-1 -1 -1 2 3 0 -1 -1 -1