-1 -1 4 0 4 2 0 -1 -1
-1 0 1 2 3 0 3 1 -1
-1 4 -1 0 1 4 1 0 -1
-1 3 0 3 4 2 -1 10 -1
-1 1 2 4 2 0 1 11 -1
-1 4 1 3 1 3 2 4 -1
-1 -1 37 39 4 0 4 -1 -1
-1 -1 -1 -1 -1 -1 -1 -1 -1
-1 -1 -1 -1 -1 -1 -1 -1 -1