-1 -1 -1 0 4 0 1 -1 -1
-1 -1 0 1 0 1 4 2 -1
-1 -1 3 2 4 3 2 0 -1
-1 -1 1 3 0 4 3 -1 -1
-1 -1 4 0 1 3 1 -1 -1
-1 -1 1 4 3 2 0 -1 -1
-1 -1 4 3 1 3 2 4 -1
-1 -1 2 0 3 4 1 0 -1
-1 -1 -1 3 4 1 0 4 -1